10111111111111111111
10000000001111111111
11101110100000000001
10101010101111111111
10101000101000001001
10101111101011101001
10100000101010001001
11110110101010111001
10000110100010000001
10111110111110111001
10100000100000100001
10101111101111101111
10101000000000000001
10101011111110101101
10001010000000100001
11111010101111101101
10000010100000100001
10111111101110101101
10000000001000100001
11111111111111111101