101111111111111
100000001110001
101111101010101
101000101010001
101011101011101
101010001000101
101011111110101
101000000010101
101011111010101
101000001010101
101111101011101
100000001000001
111111111111101